NO maps/map00.cub
SO maps/map00.cub
WE ./textures/default_n_wall
EA ./textures/default_n_wall
C 225,30,0

1111111111111111111111111111
1111111111111111111111111001
111111111111111111111111101111111
1111111111111000000001111000000011
11000000000001111111001111111110011
11011111111111111111101111111111001
10011111111111111111101111111110011
1000111111111111111100111111100011
111001111110011111100111111001111
1111011111100111111011111100111
11110111111011111110011111011
111001111110011111110111110011
110011111111011110000111111001
1101111111100000001111111111011
11001111111111111111111111110011
1110001111111111111111100111001
1111100111100000001100000000011
111111000000111110000111110111
1111111111111111111111111111