111
101
101
101
101
101
101
10111111111111111111111111111111111111111111111111111011
1S000000000000000000000000000000000000000000000000000001
11111111111111111111111111111111111111111111111111111111