..##......##..........##..::::||..........##......##......##..||::::::::::::::::::::::::::||..::::::::::::||..........##..##....
..##..##..##..######..####‡‡::||..######..##..######..##..##..||::::::::::::::::‡‡========‡‡==========‡‡==‡‡########..##..######
..##..##..##..##..##........::||..‡‡..##..##..##..##..##..##..||::::::::::::::‡‡::::::::::::::::::::::||..##......##......######
..######..##..##..##..####‡‡==‡‡::||..##..##..##..##..##..####‡‡==========‡‡::||::‡‡==‡‡======‡‡==‡‡::||..##..##..##############
......##......##..........||::::::||......##..........##..........##......##::||::::::||..::::||..::::||..‡‡..##......##......##
####..##################..||::‡‡==‡‡############################..##..##..##::‡‡==‡‡::‡‡::‡‡::||::‡‡==‡‡::||..######..##..##..##
..##..##......##..........||::||..........##..................##......##..##::::::||::::::||::||::::::::::||......##..##..##....
####..##..######..######‡‡‡‡::||..##..######..##..######################..‡‡======‡‡==‡‡==‡‡::||::::::‡‡==‡‡==‡‡..##..##..##..##
..##......##......##..::::::::||..##..##......##......##..............##..||::::::::::||....::||::::::::::::::||..##..##..##....
..##..######..######::‡‡==‡‡::‡‡==‡‡..##..######..##..##..##########..‡‡::‡‡::::::::::‡‡======‡‡::::::‡‡==‡‡::||..######..######
..##......##..##..::::||..::::::::||..........##..##......##..##......||::::::::::::::::::::::||::::::::::||::||..........##....
########..##..‡‡::‡‡==‡‡..‡‡==‡‡::‡‡======‡‡..##############..##..####||::::::::::::::::::‡‡::||::::::‡‡::‡‡==‡‡############..##
......##..##..||::::::||..##....::::::::::||......##..........##......||::::::::::::::‡‡::||::||::::::||::::::||..‡‡..........##
..##..##..##::‡‡::::::||..######‡‡====‡‡::||####..##..################‡‡==============‡‡::||::‡‡==‡‡::‡‡==‡‡::‡‡::||..##########
..##......‡‡::::::::::||..........##....::||......##..##......##..##......##............::||::::::||::||....::::::||..........##
..##..‡‡==‡‡::::::::::‡‡======‡‡..######‡‡‡‡..######..##..##..##..##..##..##############‡‡‡‡==‡‡::‡‡==‡‡..##‡‡====‡‡########..##
..##..::::::::::::::::::::::::||..............##......##..##..........##..................##..##::::::||..................‡‡....
####‡‡================‡‡::‡‡::‡‡==‡‡############..######..##########..##################..##..##::‡‡::‡‡==============‡‡::‡‡==‡‡
....::::::::::::::::::::::||::::::||############..######..##......##..............##......##....::||::::::::::::::::::||::::::::
####‡‡============‡‡::‡‡==‡‡==‡‡::||############..######..##..######‡‡====‡‡..######..##########‡‡‡‡::‡‡==‡‡======‡‡::‡‡::::::‡‡
....................::||......||::||############......##......##..::::::::||..##......##..........##::::::||......##::::::::::||
..##############..##::‡‡==‡‡::||::‡‡==‡‡########..##..######‡‡‡‡::‡‡==‡‡::||..##..##############..##‡‡====‡‡..##..##::‡‡::::::‡‡
..........##..##..##::::::::::||::::::||########..##..##..::::::::||..||::||..##..‡‡..##..........##..........##....::||::::::::
########..##..##..##‡‡========‡‡==‡‡::‡‡==‡‡####..######::‡‡======‡‡::||::‡‡==‡‡::||..##..######..##..##############::||::‡‡==‡‡
......##..‡‡......##..##..........##::::::||......##..::::||..::::::::||::::::::::||......##......##..##..........##::||::::::::
======‡‡::||########..##..##########‡‡‡‡::||..##‡‡‡‡::‡‡==‡‡::‡‡======‡‡======‡‡==‡‡########..######..##..######..##::‡‡==‡‡====
::::::::::||......##..##..............##::||..::::::::::::::::::::::::::::::::||..........##......##..##..##..##..##::::::||::::
==‡‡::‡‡==‡‡..##..##..##############..##::‡‡::‡‡==‡‡::::::::::::::::::::::‡‡::‡‡==‡‡..##########..######..##..##..##‡‡‡‡::||::‡‡
..##::||####..‡‡......##..........##..##::::::||..::::::::::::::::::::::::||::::::||..##......##......##..##..##..##....::||::||
..##::‡‡==‡‡::||..######..######..##..##‡‡====‡‡..‡‡::::::::::::::::::::::‡‡==‡‡::||..##..##..######..##..##..##..##..##‡‡‡‡::‡‡
..##::::::::::||......##......##..##......##......||::::::::::::::::::::::::::||::||..‡‡..##......##..##..##..##..##..##..##::::
####‡‡========‡‡####..######..##########..##..####‡‡::::::::::::::::::::::‡‡::||::‡‡::||..##..##..##..##..##..##..##..##..##::‡‡
..............######......##......######......##..::::::::::::::::::::::::||::||::::::||..‡‡..##......##..##..##..........##::::
############..##########..######..##############..‡‡::::::::::::::::::::::||::‡‡======‡‡::||############..##..##############‡‡‡‡
..##......##..##......##......##..................||::::::::::::::::::::::||::::::::::::::||..............##..........##........
..######..##..##..##..######..####################‡‡::::::::::::::::::::::‡‡==============‡‡..######################..##..######
......##......##..##..........##..............##..::::::::::::::::::::::::||......##..##......##......######......##......######
####..######..##..##..##########..##########..##..‡‡::‡‡======‡‡==========‡‡..##..##..##..##########..######..##..##############
..##......##..##..##..............##......##..##..##::::::::::||..............##......##..............##......##......##........
..######..######..##..##############..##..##..##..##‡‡====‡‡::||..##############..##################..##..##########..##..######
..........##......##..................##..##..##......##..##::||..........######......##########......##......##..##......##..##
####..##..##..##############################..##..##..##..##::||########..##########..##########..##########..##..######..##..##
..##..##......##..........##..................##..##..##....::||......##......##..##......######..........##......##..##..##....
..##..##################..##..##################..##..######‡‡‡‡..##..######..##..######..##############..##########..##..######
..##......##..............##......##......##......##......##......##......##..........##......######......##..............##..##
..######..##..##################..######..##..##########..##..##########..##########..######..######..######..##############..##
..........##..........##......##..........##..##......##..##..........##......##......######......##......##..........##......##
####################..######..##########..##..######..##..##..##############..##..##############..######..##########..##..######
..................##......‡‡..##......##..##......##..##..##......##......##......##......##......##......##......##..##......##
..##############..######::||..##..##..##..######..##..##..##..##..##..##############..##..##..######..######..######..######..##
..##..............##..::::||......##..##..##..##......##......##..##..........##......##..##..........##..##..........##..##....
####..##..####‡‡==‡‡::‡‡==‡‡..##..######..##..##################..##########..##..######..##############..##..######..##..######
..##..##......::::::::||......‡‡......##..........##......##..##..##......##......##......##..##..........##......##......##....
..############‡‡::::::‡‡==‡‡::||####..##..##..##..######..##..##..######..##########..##..##..##..##########..##..##############
..##..........::::::::::::::::||..##......##..##..............##......##..##..##......##..‡‡......##..........##..............##
..##..########‡‡==============‡‡..##########..######################..##..##..##..####‡‡::‡‡==‡‡..##########################..##
..##..##..................######..............##..##......##......##..##..##......##..::::::::||..............##..........##..##
..##..##..##############..##################..##..##..##..##..##..##..##..######..##..‡‡::::::||############..##..##########..##
..##..##..........##......##..............##......##..‡‡..##..##......##..##......##..::::::::||..........................##....
..##############..##..######..##########..######‡‡‡‡::||..##..##########..##..########‡‡::::::||####..##..##############..##..##
......##..........##......‡‡..........‡‡..##..::::::::||..##..........##......##......::::‡‡::||......##..........‡‡......##..##
####..##..####‡‡======‡‡::‡‡======‡‡::‡‡==‡‡::‡‡======‡‡..######..##..##########..####‡‡==‡‡::||..##########‡‡‡‡::||..##########
......##......::::::::::::::::::::::::::::::::||..........##......##......‡‡..............||::||......##..::::::::||..##......##
##############‡‡======‡‡::‡‡==‡‡==============‡‡..##########..‡‡======‡‡::‡‡==========‡‡::||::‡‡======‡‡::‡‡======‡‡..##..##..##