NO ./textures/default_n_wall
SO ./textures/default_n_wall
WE ./textures/default_n_wall
EA ./textures/default_n_wall
F 40,40,40
C 100,100,100

                                        1111111111111111111111111
                                        1000000000110011111000001
                                        1011000001110011011000001
                                        1001000000000010001000001
                                111111111011000001110000000000001
                                100000000011000001110110N01111111
                                11110111111111011100000011001
                                11110111011111011101010010001
                                11000000110101011100000010001
                                10000000000000001100000010001
                                10000000000000001101010010001
                                1100000111010101111101111000111111111111
                                11110111 1110101 10111101000000000000001
                                11111111 1111111 11111111110111111111111
