NO ./textures/hieroglyph_sprites_by_asalga1.png
EA ./textures/hieroglyph_sprites_by_asalga2.png
SO ./textures/hieroglyph_sprites_by_asalga3.png
WE ./textures/hieroglyph_sprites_by_asalga4.png
F 85,63,35
C 135,206,235

111111111111111111111111
100000000000000000000001
100000000000000000000001
100000000000000000000001
10000000S000000000000001
100000000000000000000001
100000111111111111000001
100000000000000000000001
100000000000000000000001
111111111111111111111111
