NO ./textures/default_n_wall
SO ./textures/default_s_wall
WE ./textures/default_n_wall
EA ./textures/default_s_wall
C 25,30,0
F 25,30,0

11111111111
11111011111
11110001111
11100000111
11000000011
10000000001
11000000011
11100N00111
11110001111
11111011111
11111111111