
NO maps/map00.cub                       1111111111111111111111111
SO maps/map01.cub                       100000S000110000000000001
WE ./path_to_the_west_texture           1011000001110000000000001
                                        1001000000000000000000001
                                111111111011000001110000000000001
                                100000000011000001110111111111111
     F                          11110111111111011100000010001
                                11110111111111011101010010001
EA ./path_to_the_east_texture   11000000110101011100000010001
                                10000000000000001100000010001
                                10000000000000001101010010001
                                1100000111010101111101111000111111111111111111111
                                11110111 1110101 101111010001
                                11111111 1111111 111111111111 C 225,30,0
