NO maps/map00.cub
SO maps/map00.cub
WE ./textures/default_n_wall
EA ./textures/default_n_wall
C 225,30,0

11111111111111111111111111111111111
11111111111111111111111110011111111
11111111111111111111111110111111111
11111111111110000000011110000000111
11000000000001111111001111111110011
11011111111111111111101111111111001
10011111111111111111101111111110011
10001111111111111111001111111000111
11100111111001111110011111100111111
11110111111001111110111111001111111
11110111111011111110011111011111111
11100111111001111111011111001111111
11001111111101111000011111100111111
11011111111000000011111111110111111
11001111111111111111111111110011111
11100011111111111111111001110011111
11111001111000000011000000000111111
11111100000011111000011111011111111
11111111111111111111111111111111111