NO maps/map00.cub
SO maps/map00.cub
WE ./textures/default_n_wall
EA ./textures/default_n_wall
C 225,30,0

111111111111111111111111
100000000000000000000001
100000000000000000000001
100000000000000000000001
100000000000000000000001
100000000000000000000001
100000111111111111000001
100000000000000000000001
1000000N0000000000000001
111111111111111111111111
