1111111
1001011
1010001
1100N01
