111111
1001001
1010001
1100N01
1111111