NO maps/map00.cub
SO maps/map00.cub
WE ./textures/default_n_wall
EA ./textures/default_n_wall
C 225,30,0

11111111111111111111111100
1111111111111111111111110
1111111111110000000011110000000
10000000000011111110011111111100
101111111111111111110111111111100
00111111111111111111011111111110
0001111111111111111001111111000
1100111111001111110011111100
111011111100111111011111100
11101111110111111100111110
110011111100111111101111100
1001111111101111000011111100
1011111111000000111111111110
10011111111111111111111111100
11000111111111111111110011100
1111001111000000011000000000
11111000000111111000111110