NO sadf
        1111111111111111111111111
        10000S01000110000000000001
        10110001001110000000000001
        10010001
        11111111